10 10 22 9
0 0 0 0 -1 -1 0 0 0 0 
0 S 0 0 -1 0 0 -1 0 -1 
0 0 -1 -1 -1 0 0 -1 0 -1 
0 0 F1 F2 -1 0 0 -1 0 0 
0 0 -1 -1 -1 0 0 -1 -1 0 
1 0 -1 0 0 F1 0 0 -1 0 
0 0 0 0 -1 5 -1 0 -1 0 
0 0 0 0 -1 0 0 0 0 0 
0 -1 -1 -1 -1 0 0 0 0 0 
0 0 5 0 0 0 -1 -1 -1 G