20 20 50 25
S 0 0 0 0 -1 0 0 0 0 0 0 0 0 0 0 0 0 0 0 
0 0 0 0 0 0 -1 0 0 0 0 0 0 0 0 0 0 0 0 0 
0 0 0 0 0 0 0 -1 0 0 0 0 0 0 0 0 0 0 0 0 
0 0 0 0 0 0 0 0 -1 0 0 0 0 0 0 0 0 0 0 0 
0 0 0 0 0 0 0 0 0 -1 0 0 0 0 0 0 0 0 0 0 
0 0 0 0 0 0 0 0 0 0 -1 0 0 0 0 0 0 0 0 0 
0 0 0 0 0 0 0 0 0 0 0 -1 0 0 0 0 0 0 0 0 
-1 0 0 0 0 0 0 0 0 0 0 0 -1 0 0 0 0 0 0 0 
0 -1 0 0 0 0 0 -1 -1 -1 0 0 0 -1 0 0 0 0 0 0 
0 0 -1 0 0 0 -1 -1 F1 0 0 0 0 0 -1 0 0 0 0 0 
0 0 0 -1 0 0 -1 -1 -1 -1 0 0 0 0 0 -1 0 0 0 0 
0 0 0 0 -1 0 -1 -1 -1 -1 0 0 0 0 0 5 -1 0 0 0 
0 0 0 0 -1 0 0 -1 0 -1 0 0 0 0 -1 0 0 -1 0 0 
0 0 0 0 -1 -1 0 0 0 0 0 0 0 -1 0 0 0 0 -1 0 
0 0 0 0 0 0 -1 -1 0 0 0 0 -1 0 0 0 0 0 0 -1 
0 0 0 0 0 0 0 0 -1 0 0 -1 0 0 0 0 0 0 0 0 
0 0 0 0 0 0 0 0 0 -1 10 0 0 0 0 0 0 0 0 0 
0 0 0 0 0 0 0 0 0 0 -1 0 0 0 0 0 0 0 0 0 
0 0 0 0 0 0 0 0 0 0 0 -1 0 0 0 0 0 0 0 0 
0 0 0 0 0 0 0 0 0 0 0 0 -1 0 0 0 0 0 0 G 
