13 9 40 30
-1 -1 -1 -1 G3 -1 -1 -1 -1
-1 -1 -1 -1 S2 -1 -1 -1 -1
-1 -1  0  0  0  0  0 -1 -1
-1 -1  0 -1  0 -1  0 -1 -1
-1 -1  0 -1  0 -1  0 -1 -1
-1 -1  0 -1  0 -1  0 -1 -1
G2 S1  0  0  0  0  0  S3 G
-1 -1  0 -1  0 -1  0 -1 -1
-1 -1  0 -1  0 -1  0 -1 -1
-1 -1  0 -1  0 -1  0 -1 -1
-1 -1  0  0  0  0  0 -1 -1
-1 -1 -1 -1  S -1 -1 -1 -1
-1 -1 -1 -1 G1 -1 -1 -1 -1
