11 11 50 30
-1 -1 -1 -1 -1 -1 -1 -1 -1 -1 -1
-1 -1  0 10  0  0  0  0  0 -1 -1
-1 -1  0 -1  0 -1 -1 -1  0 -1 -1
-1 -1  0 -1  0  0 G1 -1  0 -1 -1
 S -1  0 -1  0 -1 -1 -1  0 -1 -1
S2  0  0 -1  0  0  0  0  0  0  G
S1 -1  0 -1  0 -1 -1 -1  0 -1 -1
-1 -1  0 -1  0  0 G2 -1  0 -1 -1
-1 -1  0 -1  0 -1 -1 -1  0 -1 -1
-1 -1  0  0  0  0  0  0  0 -1 -1
-1 -1 -1 -1 -1 -1 -1 -1 -1 -1 -1
