20 20 78 inf
S 0 0 0 0 -1 -1 -1 -1 -1 -1 -1 -1 -1 -1 -1 -1 -1 -1 -1 
0 -1 0 -1 0 -1 0 0 0 0 0 0 0 0 0 0 0 0 0 -1 
0 -1 0 -1 0 -1 0 0 0 0 0 0 0 0 0 0 0 0 0 -1 
0 -1 -1 -1 0 -1 0 -1 -1 -1 -1 -1 -1 -1 -1 -1 0 -1 0 -1 
0 -1 0 -1 0 -1 0 0 0 0 0 0 0 6 0 -1 0 -1 0 -1 
0 -1 0 -1 0 -1 -1 -1 -1 -1 -1 -1 -1 -1 0 -1 0 -1 0 -1 
0 -1 0 -1 0 0 0 0 0 0 0 0 0 0 0 -1 0 -1 0 0 
0 -1 0 -1 -1 -1 -1 -1 -1 -1 -1 -1 -1 -1 0 -1 0 -1 0 0 
0 -1 0 0 0 0 0 0 0 -1 0 0 0 0 0 -1 0 -1 0 0 
0 -1 -1 -1 -1 -1 -1 -1 0 -1 0 -1 -1 -1 -1 -1 0 -1 0 0 
0 0 0 0 0 0 0 0 0 -1 0 0 0 0 0 0 0 -1 0 0 
-1 -1 -1 -1 -1 -1 0 -1 -1 -1 -1 -1 -1 -1 -1 -1 -1 -1 0 0 
0 0 0 0 0 0 12 0 0 -1 0 0 -1 0 0 0 0 0 0 -1 
0 -1 -1 -1 -1 -1 0 -1 -1 -1 0 0 -1 0 0 0 0 0 0 -1 
0 -1 0 0 0 -1 0 -1 0 0 0 0 -1 0 -1 -1 -1 -1 -1 -1 
0 -1 0 -1 0 -1 0 -1 0 0 0 0 -1 0 -1 G 0 0 0 0 
-1 -1 0 -1 0 -1 0 -1 0 -1 -1 -1 -1 0 -1 0 0 0 0 -1 
0 0 0 -1 0 0 0 -1 0 0 0 9 0 0 -1 -1 -1 -1 0 -1 
0 0 0 -1 -1 -1 -1 -1 0 -1 -1 -1 0 0 0 0 0 0 0 -1 
-1 -1 0 0 0 0 0 0 0 0 0 -1 0 -1 -1 -1 -1 -1 -1 -1 
