10 10 99 12
 S G1  0  0  0  0  0 G5  0 G3
-1 -1 -1  0 -1  0  0  0  0  0
 0 G4 -1  0  0 F1  0  0  0  0
S1 -1  0  0  0  0  0  0  0  0
 0  0  0  0  0  0  0  0  0  0
 0  0 -1  0  0  0  0  0 G2  0
S2 -1  0  0 F1  0  0  0  0  0
 0  0  0  0  0  0  0  0  0  0
 0  0  0  0  0  0  0  0  0  G
S3  0  0  0 S4  0  0  0 S5  0