20 20 65 inf
0 0 0 0 0 0 0 0 0 0 0 0 0 0 15 15 15 15 0 0 
0 0 0 0 0 15 15 15 15 15 15 15 15 15 0 0 0 0 15 0 
0 15 0 15 15 0 0 0 0 0 0 0 0 0 0 0 0 0 15 0 
0 0 15 0 0 0 0 15 15 15 15 15 15 15 15 0 0 0 0 15 
S 0 0 0 15 15 15 0 0 0 0 0 0 0 15 0 0 0 0 15 
0 0 0 15 0 0 0 0 0 0 0 0 15 15 0 0 0 0 0 15 
0 15 15 0 0 0 0 0 0 0 15 15 0 0 0 15 15 15 15 0 
0 0 0 0 0 0 0 0 15 15 0 0 0 0 15 15 0 0 0 0 
0 0 0 0 0 0 15 15 0 0 0 0 0 15 0 0 0 0 0 0 
0 0 0 15 15 15 0 0 0 0 0 15 15 0 0 0 0 0 0 0 
0 0 15 0 0 0 0 15 15 15 15 0 0 15 15 15 15 15 15 0 
15 15 0 0 15 15 15 0 0 0 0 0 15 0 0 0 0 0 0 15 
0 0 0 15 0 0 0 0 0 0 0 0 15 0 15 15 15 15 0 15 
0 0 0 15 0 0 0 0 0 0 0 0 15 0 15 0 0 15 0 15 
0 0 0 15 0 0 0 0 0 0 0 0 15 0 15 0 0 15 0 15 
0 0 0 15 0 0 0 0 0 0 0 0 15 0 15 0 G 15 0 15 
0 0 0 15 0 0 0 0 0 0 0 0 15 0 15 0 15 15 0 15 
0 0 0 0 15 15 15 15 15 15 15 15 0 0 15 0 15 15 0 15 
0 0 0 0 0 0 0 0 0 0 0 0 0 0 15 0 0 0 0 15 
0 0 0 0 0 0 0 0 0 0 0 0 0 0 0 15 15 15 15 0 
