10 10 99 99
S9   0  0  0 -1  0  0  0 -1 G
S8  0 -1  0  0  0 -1  0 -1 G1
S7  0  0  0 -1  0  0  0 -1 G2
S6  0 -1  0  0  0 -1  0 -1 G3
S5  0  0  0 -1  0  0  0 -1 G4
S4  0  0  0 -1  0  0  0 -1 G5
S3  0 -1  0  0  0 -1  0 -1 G6
S2  0  0  0 -1  0  0  0 -1 G7
S1  0 -1  0  0  0 -1  0 -1 G8
S   0  0  0 -1  0  0  0  0 G9