20 20 81 inf
S 0 0 0 0 -1 -1 -1 -1 -1 -1 -1 -1 -1 -1 -1 -1 -1 -1 -1 
0 -1 0 -1 0 -1 0 0 0 0 0 0 0 0 0 0 0 0 0 -1 
0 -1 0 -1 0 -1 0 0 0 0 0 0 0 0 0 0 0 0 0 -1 
0 -1 -1 -1 0 -1 0 -1 -1 -1 -1 -1 -1 -1 -1 -1 0 -1 0 -1 
0 -1 0 -1 0 -1 0 0 0 0 0 0 0 10 0 -1 0 -1 0 -1 
0 -1 0 -1 0 -1 -1 -1 -1 -1 -1 -1 -1 -1 0 -1 0 -1 0 -1 
0 -1 0 -1 0 0 0 0 0 0 0 0 0 4 0 -1 0 -1 0 0 
0 -1 0 -1 -1 -1 -1 -1 -1 -1 -1 -1 -1 -1 0 -1 0 -1 0 0 
0 -1 0 0 0 0 0 0 0 -1 0 0 0 0 0 -1 0 -1 0 0 
0 -1 -1 -1 -1 -1 -1 -1 0 -1 0 -1 -1 -1 -1 -1 0 -1 0 0 
0 0 0 0 0 0 0 0 0 -1 0 0 0 0 0 0 0 -1 0 0 
-1 -1 -1 -1 -1 -1 0 -1 -1 -1 -1 -1 -1 -1 -1 -1 -1 -1 0 0 
0 0 0 0 0 0 16 0 0 -1 0 0 -1 0 0 0 0 0 0 -1 
0 -1 -1 -1 -1 -1 0 -1 -1 -1 0 0 -1 0 0 0 0 0 0 -1 
0 -1 0 0 0 -1 0 -1 0 0 0 0 -1 0 -1 -1 -1 -1 -1 -1 
0 -1 0 -1 0 -1 0 -1 0 0 0 0 -1 0 -1 G 0 0 0 0 
-1 -1 0 -1 0 -1 0 -1 0 -1 -1 -1 -1 0 -1 0 0 0 0 -1 
0 0 0 -1 0 0 0 -1 0 0 0 9 0 0 -1 -1 -1 -1 0 -1 
0 0 0 -1 -1 -1 -1 -1 0 -1 -1 -1 0 0 0 0 0 0 0 -1 
-1 -1 0 0 0 0 0 0 0 0 0 -1 0 -1 -1 -1 -1 -1 -1 -1 
