20 19 26 14
0 0 0 0 0 0 0 0 0 0 0 0 0 0 0 0 0 0 0 
0 0 0 0 0 0 0 0 0 0 0 0 0 0 0 0 0 0 0 
0 0 0 0 0 0 0 0 0 0 0 0 0 0 0 0 0 0 0 
0 0 0 0 0 0 0 0 0 0 0 0 0 0 0 0 0 0 0 
0 -1 -1 -1 -1 -1 -1 -1 -1 -1 -1 -1 -1 -1 -1 -1 -1 -1 0 
0 -1 0 0 0 0 0 0 0 0 0 0 F12 0 0 0 0 -1 0 
0 -1 0 0 0 0 0 0 0 0 0 0 F12 0 0 0 0 -1 0 
0 -1 0 0 0 0 0 0 0 0 0 0 F12 0 0 0 0 -1 0 
0 -1 0 0 0 0 0 0 0 0 0 0 F12 0 0 0 0 -1 0 
0 -1 S -1 -1 -1 -1 -1 -1 -1 -1 -1 -1 -1 -1 -1 G -1 0 
0 -1 0 0 0 0 0 0 0 0 0 0 0 0 0 0 0 -1 0 
0 -1 0 0 0 0 0 0 0 0 0 0 0 0 0 0 0 -1 0 
0 -1 0 0 0 0 0 0 0 0 0 0 0 0 0 0 0 -1 0 
0 -1 0 0 0 0 0 0 0 0 0 0 0 0 0 0 0 -1 0 
0 -1 -1 -1 -1 -1 -1 -1 -1 -1 -1 -1 -1 -1 -1 -1 -1 -1 0 
0 0 0 0 0 0 0 0 0 0 0 0 0 0 0 0 0 0 0 
0 0 0 0 0 0 0 0 0 0 0 0 0 0 0 0 0 0 0 
0 0 0 0 0 0 0 0 0 0 0 0 0 0 0 0 0 0 0 
0 0 0 0 0 0 0 0 0 0 0 0 0 0 0 0 0 0 0 
0 0 0 0 0 0 0 0 0 0 0 0 0 0 0 0 0 0 0 