5 7 100 100
-1 -1 -1 -1 -1 -1 -1
 0  0  0  0  0 S1  G
-1 -1 -1  0 -1 -1 -1
-1 -1 -1  S -1 -1 -1
-1 -1 -1 G1 -1 -1 -1