20 20 100 22
S 0 0 0 0 -1 -1 -1 -1 -1 -1 -1 -1 -1 -1 -1 -1 -1 -1 -1 
0 -1 0 -1 0 -1 0 0 0 0 0 0 0 0 0 0 0 0 0 -1 
0 -1 0 -1 0 -1 0 0 0 0 0 0 0 0 0 0 0 0 0 -1 
0 -1 -1 -1 0 -1 0 -1 -1 -1 -1 -1 -1 -1 -1 -1 0 -1 0 -1 
0 -1 0 -1 0 -1 0 0 0 0 0 0 0 0 0 -1 0 -1 0 -1 
0 -1 0 -1 0 -1 -1 -1 -1 -1 -1 -1 -1 -1 0 -1 0 -1 0 -1 
0 -1 0 -1 0 0 0 0 0 0 0 0 0 0 0 -1 0 -1 0 0 
0 -1 0 -1 -1 -1 -1 -1 -1 -1 -1 -1 -1 -1 0 -1 0 -1 0 0 
0 -1 0 0 0 0 0 0 0 -1 0 0 0 0 0 -1 0 -1 0 0 
0 -1 -1 -1 -1 -1 -1 -1 F1 -1 0 -1 -1 -1 -1 -1 0 -1 0 0 
0 0 0 0 0 0 0 0 0 -1 0 0 0 0 0 0 0 -1 0 0 
-1 -1 -1 -1 -1 -1 0 -1 -1 -1 -1 -1 -1 -1 -1 -1 -1 -1 0 0 
0 0 0 0 0 0 0 0 0 -1 0 0 -1 0 0 0 0 0 0 -1 
0 -1 -1 -1 -1 -1 0 -1 -1 -1 0 0 -1 0 F1 0 0 0 0 -1 
0 -1 0 F1 0 -1 0 -1 0 0 0 0 -1 0 -1 -1 -1 -1 -1 -1 
0 -1 0 -1 0 -1 0 -1 0 0 0 0 -1 0 -1 G 0 0 0 0 
-1 -1 0 -1 0 -1 0 -1 0 -1 -1 -1 -1 0 -1 0 0 0 0 -1 
0 0 0 -1 0 0 0 -1 0 0 0 0 0 0 -1 -1 -1 -1 0 -1 
0 0 0 -1 0 0 0 0 0 -1 -1 -1 0 0 0 0 0 0 0 -1 
-1 -1 -1 -1 -1 -1 -1 -1 0 0 0 -1 0 -1 -1 -1 -1 -1 -1 -1 


