20 20 40 inf
0 0 0 0 0 0 0 0 0 0 0 0 0 0 0 0 0 0 0 0 
0 -1 -1 0 0 -1 -1 -1 0 0 -1 0 0 -1 -1 0 -1 -1 0 0 
0 -1 -1 0 0 0 -1 0 0 0 0 0 0 -1 -1 0 -1 -1 0 0 
0 0 0 0 -1 0 0 0 0 0 0 0 0 -1 0 0 -1 -1 0 0 
0 -1 0 -1 -1 0 0 0 0 0 0 0 0 0 0 0 -1 -1 0 0 
0 0 0 0 0 0 0 -1 50 50 50 50 -1 0 0 0 0 0 0 0 
0 0 0 0 0 0 -1 0 0 0 0 0 0 -1 0 0 0 0 0 0 
0 0 0 0 0 -1 0 0 0 0 0 0 0 0 -1 0 0 0 0 0 
0 -1 -1 -1 -1 0 0 0 0 0 0 0 0 0 0 -1 -1 -1 -1 0 
0 0 0 0 0 0 0 0 0 0 S 0 0 0 0 32 0 0 0 G 
0 -1 -1 -1 -1 0 0 0 0 0 0 0 0 0 0 -1 -1 -1 -1 0 
0 0 0 0 0 -1 0 0 0 0 0 0 0 0 -1 0 0 0 0 0 
0 0 0 0 0 0 -1 0 0 0 0 0 0 -1 0 0 0 0 0 0 
0 0 0 0 0 0 0 -1 50 50 50 50 -1 0 0 0 0 0 0 0 
0 0 0 0 0 0 0 0 0 0 0 0 0 0 0 0 0 0 0 0 
0 -1 -1 -1 -1 0 0 0 0 0 0 0 0 0 0 -1 -1 -1 0 0 
0 0 0 -1 -1 0 0 0 0 0 0 0 0 0 -1 -1 0 0 0 0 
0 0 -1 0 -1 0 0 0 0 0 0 0 0 0 -1 -1 -1 -1 0 0 
0 -1 0 0 -1 0 0 0 0 0 0 0 0 0 -1 -1 -1 -1 0 0 
0 0 0 0 0 0 0 0 0 0 0 0 0 0 0 -1 0 -1 0 0 
